Load=[layers]

Load=[TileSet][TileDimensions]
[tileset1][32,32]


Load=[StartLayer]

[0,0][0,0][0,0][0,0][0,0][0,0][0,0][0,0][0,0][0,0][0,0][0,0][0,0][0,0][0,0][0,0][0,0][0,0][0,0][0,0]
[0,0][0,0][0,0][0,0][0,0][0,0][0,0][0,0][0,0][0,0][0,0][0,0][0,0][0,0][0,0][0,0][0,0][0,0][0,0][0,0]
[0,0][0,0][0,0][0,0][0,0][0,0][0,0][0,0][0,0][0,0][0,0][0,0][0,0][0,0][0,0][0,0][0,0][0,0][0,0][0,0]
[0,0][0,0][0,0][0,0][0,0][0,0][0,0][0,0][0,0][0,0][0,0][0,0][0,0][0,0][0,0][0,0][0,0][0,0][0,0][0,0]
[0,0][0,0][0,0][0,0][0,0][0,0][0,0][0,0][0,0][0,0][0,0][0,0][0,0][0,0][0,0][0,0][0,0][0,0][0,0][0,0]
[0,0][0,0][0,0][0,0][0,0][0,0][0,0][0,0][0,0][0,0][0,0][0,0][0,0][0,0][0,0][0,0][0,0][0,0][0,0][0,0]
[0,0][0,0][0,0][0,0][0,0][0,0][0,0][0,0][0,0][0,0][0,0][0,0][0,0][0,0][0,0][0,0][0,0][0,0][0,0][0,0]
[0,0][0,0][0,0][0,0][0,0][0,0][0,0][0,0][2,0][2,0][2,0][2,0][0,0][0,0][0,0][0,0][0,0][0,0][0,0][0,0]
[0,0][0,0][0,0][0,0][0,0][0,0][0,0][2,0][0,0][0,0][0,0][0,0][0,0][0,0][0,0][0,0][0,0][0,0][0,0][0,0]
[0,0][0,0][0,0][0,0][0,0][0,0][2,0][0,0][0,0][0,0][0,0][0,0][0,0][0,0][0,0][0,0][0,0][0,0][0,0][0,0]
[0,0][0,0][0,0][0,0][0,0][0,0][0,0][0,0][0,0][0,0][0,0][0,0][0,0][0,0][0,0][0,0][0,0][0,0][0,0][0,0]
[0,0][0,0][2,0][2,0][2,0][0,0][0,0][0,0][0,0][0,0][0,0][0,0][0,0][0,0][0,0][0,0][0,0][0,0][0,0][0,0]
[0,0][0,0][0,0][0,0][0,0][0,0][0,0][0,0][0,0][0,0][0,0][0,0][0,0][0,0][0,0][0,0][0,0][0,0][0,0][0,0]
[0,0][0,0][0,0][0,0][0,0][0,0][0,0][0,0][0,0][0,0][0,0][0,0][0,0][0,0][0,0][0,0][0,0][0,0][0,0][0,0]
[1,0][1,0][1,0][1,0][1,0][1,0][1,0][1,0][1,0][1,0][1,0][1,0][1,0][1,0][1,0][1,0][1,0][1,0][1,0][1,0]

Load=[EndLayer]
[dummy]

EndLoad=[Layers]